крÿптернор - to encrypt - Verb
гекрÿптернор - to decrypt - Verb
пуjупнор - to use - Verb
кÿÿхи - name - Noun
шÿфõнор - to be - Verb
дувöзовõфо - language - Noun
хувеч - key - Noun
телефон - telephone - Noun
авäммахе - mother - Noun
зõтöнöмä - father - Noun
сестрä - sister - Verb
шахÿжадÿ - number - Noun
америка - america - Noun
еести - estonia - Noun
чхеки - czech republic - Noun
мõжувоттах - password - Noun
шиичöжÿз - school - Noun
пиjиф - old - Adjective
jовÿлопõв - username - Noun
демук - char - Noun - [Programming characters]
уклäрш - set - Noun - [Mathmatical or programming set]
äлõнäжöм - length - Noun
дÿшежнор - to admire - Verb
ÿнöфäфõз - person - Noun
идиjüт - idiot - Noun
кõõрул - complicated - Adjective
бинежÿду - simple - Adjective
геениус - genius - Noun
абäфÿjõвäнн - question - Noun
жахäфок - thing - Noun
рöхкем - more - Adverb
сäда - it - Noun
ноннÿнор - get - Verb
пузагõтнор - build - Verb
нjии - ever so - Adverb
нjии - like this - Adverb
ухужи - god - Noun
дÿпöфиjнор - think - Verb
кõõмасанор - to understand - Verb
мõшелäнадö - academic - Adjective
ишапечäшö - journal - Noun
модибутнор - write - Verb
упржинор - try - Verb
шÿнöбонор - make - Verb
кивä - stone - Noun
ежäнöтак - server - Noun - [Computer server]
минги - some kind of - Adjective
рÿиjот - robot - Noun
чуккäмнор - to talk - Verb
кõхт - place - Noun
зõкõнубнор - to voice - Verb
мохафевнор - to quote - Verb
инглис - english - Adjective
мÿзанäхонор - to author - Verb
гäжöпесунор - to announce - Verb
аÿтанор - to help - Verb
jесидäнор - to preform - Verb
луверувуфух - important - Adjective
т - that - Conjunction
сÿстет - because - Conjunction
иö - not - Adverb
здрасте - hello - Interjection
yes - да - Adverb
no - но - Adverb
maybe - вõибола - Adverb
and - jи - Conjunction
четичанор - to test - Verb
кÿлинор - to invite - Verb
увõжапÿк - friend - Noun
лиäпäл - link - Noun
мÿзикjа - music - Noun
кармõшка - garmon - Noun
нÿсäшовÿзäнор - to serve - Verb
зонÿбõбäви - article - Noun
ифäзоовäпöнор - to plan - Verb
вäрукõпиа - backup - Noun
чуккäм - word - Noun
фовимужäсунор - to design - Verb
